+----+----+----+----+----+----+----+----+----+----+----+----+----+----+----+----+----+----+----+----+
     |         |         |                   |         |                             |         |    |
     |         |         |                   |         |                             |         |    |
     |         |         |                   |         |                             |         |    |
+    +    +    +    +    +    +----+----+    +    +    +    +----+----+    +----+    +    +    +    +
|         |         |    |              |         |    |    |         |    |         |    |         |
|         |         |    |              |         |    |    |         |    |         |    |         |
|         |         |    |              |         |    |    |         |    |         |    |         |
+----+----+----+----+    +----+----+    +----+----+    +    +----+    +    +    +----+----+    +    +
|                   |              |         |         |         |         |              |    |    |
|                   |              |         |         |         |         |              |    |    |
|                   |              |         |         |         |         |              |    |    |
+    +----+    +----+----+----+    +----+    +    +----+----+    +    +----+----+----+    +    +    +
|         |                             |    |    |         |    |    |              |    |    |    |
|         |                             |    |    |         |    |    |              |    |    |    |
|         |                             |    |    |         |    |    |              |    |    |    |
+    +----+----+----+----+----+----+----+    +    +    +    +    +    +    +----+    +    +    +    +
|                                            |         |         |         |         |         |     
|                                            |         |         |         |         |         |     
|                                            |         |         |         |         |         |     
+----+----+----+----+----+----+----+----+----+----+----+----+----+----+----+----+----+----+----+----+

