+---+---+---+---+---+---+---+---+---+---+---+---+---+---+---+---+---+---+---+---+---+---+---+---+---+
        |               |       |       |           |       |       |       |   |                   |
        |               |       |       |           |       |       |       |   |                   |
        |               |       |       |           |       |       |       |   |                   |
+---+   +   +---+---+   +   +   +   +   +   +---+   +---+   +   +   +---+   +   +   +---+---+---+   +
|       |   |           |   |       |   |       |       |   |   |   |       |       |       |       |
|       |   |           |   |       |   |       |       |   |   |   |       |       |       |       |
|       |   |           |   |       |   |       |       |   |   |   |       |       |       |       |
+   +---+   +   +   +---+   +---+---+   +---+   +---+   +   +   +   +   +---+---+   +   +---+   +---+
|       |   |   |   |           |       |       |   |           |       |       |       |           |
|       |   |   |   |           |       |       |   |           |       |       |       |           |
|       |   |   |   |           |       |       |   |           |       |       |       |           |
+---+   +   +---+   +---+---+   +   +---+---+---+   +   +   +---+---+---+   +   +   +---+   +---+---+
|       |   |               |   |   |               |   |               |   |   |   |               |
|       |   |               |   |   |               |   |               |   |   |   |               |
|       |   |               |   |   |               |   |               |   |   |   |               |
+   +---+---+   +   +---+   +   +   +---+   +---+---+   +---+---+   +   +   +   +---+   +---+---+   +
|               |       |       |                       |           |       |           |            
|               |       |       |                       |           |       |           |            
|               |       |       |                       |           |       |           |            
+---+---+---+---+---+---+---+---+---+---+---+---+---+---+---+---+---+---+---+---+---+---+---+---+---+