+--+--+--+--+--+--+--+--+--+--+--+--+--+--+--+--+--+--+--+--+--+--+--+--+--+--+--+--+--+--+--+--+--+
         |        |     |     |     |     |                 |     |     |     |                    |
         |        |     |     |     |     |                 |     |     |     |                    |
+  +--+  +  +--+--+  +  +  +  +  +  +--+  +  +--+--+--+--+  +  +  +  +  +  +  +--+  +--+--+--+--+  +
|  |     |  |  |     |     |     |  |        |        |        |  |  |     |     |        |        |
|  |     |  |  |     |     |     |  |        |        |        |  |  |     |     |        |        |
+  +  +--+  +  +  +--+--+--+--+--+  +  +--+--+  +--+  +  +--+--+  +  +--+--+--+  +--+--+  +  +--+--+
|  |  |     |     |     |        |        |  |  |     |     |  |  |     |                 |        |
|  |  |     |     |     |        |        |  |  |     |     |  |  |     |                 |        |
+  +  +  +--+  +  +  +  +  +  +--+--+--+  +  +  +--+--+--+  +  +  +--+  +  +  +--+--+--+--+--+--+  +
|  |     |     |  |  |     |     |           |              |           |  |  |                 |  |
|  |     |     |  |  |     |     |           |              |           |  |  |                 |  |
+  +--+--+  +--+  +  +--+--+--+  +  +--+--+  +--+--+--+--+--+--+  +--+--+  +--+  +--+--+  +--+  +  +
|  |     |  |  |  |  |        |  |  |     |        |     |        |     |  |        |     |     |  |
|  |     |  |  |  |  |        |  |  |     |        |     |        |     |  |        |     |     |  |
+  +  +  +  +  +  +  +  +--+  +  +  +--+  +--+--+  +  +  +  +--+--+  +  +--+  +--+--+  +--+  +--+  +
|     |     |     |     |     |           |        |  |     |        |        |           |         
|     |     |     |     |     |           |        |  |     |        |        |           |         
+--+--+--+--+--+--+--+--+--+--+--+--+--+--+--+--+--+--+--+--+--+--+--+--+--+--+--+--+--+--+--+--+--+
