+--+--+--+--+--+--+--+--+--+--+--+--+--+--+--+--+--+--+--+--+--+--+--+--+--+--+--+--+--+--+--+--+--+--+--+--+--+--+--+--+--+--+--+--+--+--+--+--+--+--+
      |     |     |  |        |           |        |     |        |     |        |  |           |              |     |     |           |     |        |
+  +  +  +  +  +  +  +  +--+  +  +--+--+  +--+--+  +--+  +  +--+  +  +  +  +--+  +  +  +  +--+--+  +--+--+  +  +  +  +  +  +  +--+--+  +  +  +  +--+  +
|  |     |  |  |           |     |     |  |     |  |     |     |  |  |  |     |        |     |     |        |     |     |           |     |  |     |  |
+  +--+--+  +  +--+--+  +  +--+--+  +  +  +  +  +  +  +--+--+  +  +--+  +--+  +--+--+--+--+  +  +--+  +--+--+--+--+--+--+--+  +--+  +--+--+  +--+  +  +
|  |     |     |        |     |  |  |  |  |  |  |  |     |     |           |     |           |  |  |  |     |                 |     |     |  |     |  |
+  +  +--+--+--+  +--+--+--+  +  +  +  +  +  +  +  +  +  +  +--+--+--+--+  +--+  +--+  +--+--+  +  +  +  +  +--+--+  +  +--+--+  +--+  +--+  +--+--+  +
|  |  |     |  |     |     |  |     |  |     |  |  |  |  |        |  |        |     |     |     |     |  |  |     |  |  |     |     |        |        |
+  +  +  +  +  +--+  +  +  +  +  +--+--+--+--+  +  +--+  +--+--+  +  +  +--+--+--+  +--+  +  +--+  +--+  +--+  +  +  +  +  +  +--+  +--+--+--+  +  +--+
|     |  |  |     |     |  |  |        |        |  |     |     |     |        |  |     |  |  |  |  |  |     |  |     |     |     |     |        |  |  |
+--+--+  +--+  +  +--+--+  +  +  +--+  +  +--+--+  +  +  +  +  +--+--+--+--+  +  +--+  +  +  +  +  +  +--+  +  +  +--+--+--+--+--+--+  +  +--+--+  +  +
|              |           |     |     |           |  |  |  |     |  |        |        |     |     |        |  |  |     |              |  |     |     |
+  +--+  +--+--+--+--+--+--+--+  +  +--+--+--+  +--+  +  +  +--+  +  +  +  +--+--+--+  +--+--+--+  +--+  +--+  +  +--+  +  +--+  +--+--+  +--+  +--+  +
|  |     |        |              |  |     |     |     |     |  |  |     |           |     |     |     |        |        |     |  |              |     |
+--+  +--+  +--+  +--+--+--+--+--+  +  +  +  +--+  +  +--+--+  +  +  +  +--+--+--+  +--+  +--+  +  +--+--+--+--+--+--+--+--+  +--+  +--+  +  +--+--+--+
|        |     |  |              |  |  |  |        |           |     |           |  |     |     |  |     |                 |     |  |  |  |  |        |
+  +--+--+  +--+  +  +--+  +--+--+  +  +  +--+--+--+--+--+--+--+--+--+--+--+  +--+  +  +--+  +--+--+  +--+  +--+--+--+--+  +--+  +  +  +  +  +--+--+  +
|  |     |  |     |     |  |        |  |     |  |                          |  |     |  |  |  |        |        |     |  |     |     |     |  |        |
+  +--+  +--+  +--+  +  +  +  +--+--+--+--+  +  +  +--+--+--+--+--+--+--+  +--+  +--+  +  +  +  +--+--+  +  +  +  +  +  +  +  +--+--+--+--+  +  +--+--+
|              |     |  |                       |                       |              |                 |  |     |     |  |                           
+--+--+--+--+--+--+--+--+--+--+--+--+--+--+--+--+--+--+--+--+--+--+--+--+--+--+--+--+--+--+--+--+--+--+--+--+--+--+--+--+--+--+--+--+--+--+--+--+--+--+
