+--+--+--+--+--+--+--+--+--+--+--+--+--+--+--+--+--+--+--+--+--+--+--+--+--+--+--+--+--+--+--+--+--+--+--+--+--+--+--+--+--+--+--+--+--+--+--+--+--+--+
   |                    |     |                             |           |     |     |           |     |     |              |           |     |     |  |
+  +  +--+--+  +--+--+  +  +  +  +--+--+--+--+  +--+  +--+  +  +--+--+  +  +  +  +  +  +--+--+  +  +  +  +  +  +--+--+--+  +  +--+--+  +  +  +--+  +  +
|     |     |  |     |  |  |  |     |           |     |        |        |  |  |  |  |  |     |     |     |     |           |  |     |  |  |           |
+--+--+  +  +  +  +--+  +  +  +--+  +  +--+--+--+--+--+--+--+--+  +--+--+--+  +  +  +  +--+  +--+  +--+--+--+--+  +--+--+--+  +  +--+  +--+--+--+--+  +
|     |  |     |     |     |  |     |  |           |     |        |           |  |  |     |        |  |        |  |     |     |        |     |        |
+--+  +  +--+--+--+  +--+--+  +  +--+  +  +--+--+  +  +  +  +--+--+--+  +--+--+--+  +--+  +--+  +  +  +  +--+  +  +  +  +  +--+--+--+  +  +  +  +--+--+
|     |        |     |     |     |     |  |     |     |  |              |           |     |     |  |        |  |  |  |  |  |        |     |  |        |
+  +--+--+--+--+  +--+--+  +--+--+  +--+  +  +  +--+--+  +--+--+--+  +  +  +--+--+--+  +--+  +--+--+--+--+  +  +  +  +  +  +  +--+  +--+--+  +  +--+  +
|  |  |        |                       |     |  |        |     |     |  |     |     |  |     |     |        |     |  |  |  |  |     |        |  |     |
+  +  +  +--+  +  +--+--+--+--+--+--+--+--+--+--+  +--+--+  +  +  +--+--+--+  +--+  +  +--+--+  +  +--+  +--+--+--+  +  +  +  +  +--+  +--+--+  +  +--+
|     |  |  |     |  |           |        |        |        |  |              |        |        |     |              |     |  |     |  |        |  |  |
+  +--+  +  +--+--+  +  +--+--+  +  +  +--+  +--+--+  +  +--+  +--+--+  +--+--+  +  +--+  +  +--+--+  +--+--+--+  +--+--+--+  +--+  +  +--+--+--+  +  +
|  |     |        |     |     |     |     |     |     |  |     |     |           |        |     |     |     |     |        |     |  |     |        |  |
+  +  +--+--+  +  +--+--+  +--+  +--+--+  +  +  +  +--+  +--+  +  +--+--+--+--+  +--+--+--+--+  +--+--+--+  +  +--+  +--+  +--+  +  +--+  +  +--+--+  +
|  |     |     |  |     |           |     |  |  |  |  |     |  |        |        |           |     |  |        |     |     |     |  |     |        |  |
+  +--+  +  +--+--+  +  +--+--+--+  +  +--+  +  +  +  +--+  +--+--+--+  +  +--+--+  +  +--+--+--+  +  +  +--+--+  +--+  +--+  +--+  +  +--+  +--+  +  +
|  |     |        |  |           |  |  |     |     |     |              |     |     |  |        |     |           |  |  |     |     |     |  |     |  |
+  +  +  +  +--+  +  +--+--+--+  +  +  +  +--+  +--+--+  +  +--+  +--+--+  +  +  +--+--+  +--+  +--+  +--+--+  +--+  +  +--+--+  +--+  +--+  +  +--+  +
|     |        |              |     |     |     |           |     |        |  |           |                 |        |              |        |         
+--+--+--+--+--+--+--+--+--+--+--+--+--+--+--+--+--+--+--+--+--+--+--+--+--+--+--+--+--+--+--+--+--+--+--+--+--+--+--+--+--+--+--+--+--+--+--+--+--+--+