111111111111111111111111111111111111111111111111111111111111111111111111111111111111111111111111111111111111111111111111
100000000000000000000100000000000000000000000000000000000000000000000000000000000000000000000000000000000000000000000001
100000000000000000000100000000000000000000000000000000000000000000000000000000000000000000000000000000000000000000000001
100000000000000000000000000000000000000000000000000000000000000000000000000000000000000000000000000000000000000000000001
100000000000000000000000000000000000000000000000000000000000000000000000000000000000000000000000000000000000000000000001
100000000000000000000000000000000000000000000000000000000000000000000000000000000000000000000000000000000000000000000001
100000000000000000000000000000000000000000000000000000000000000000000000000000000000000000000000000000000000000000000001
100000000000000000000000000000000000000000000000000000000000000000000000000000000000000000000000000000000000000000000001
100000000000000000000100000000000000000000000000000000000000000000000000000000000000000000000000000000000000000000000001
100000000000000000000100000000000000000022222222222222222222000000000000000000000000000000000000000000000000000000000001
100000000000000000000100000000000000000022222222222222222222000000000000000000000000000000000000000000000000000000000001
111111111111111111111100000000000000000000000000000000000000000000000000000000000000000000000000000000000000000000000001
444444444444444444444100000000000000000000000000000000000000000000000000000000000000000000000000000000000000000000000001
444444444444444444444100000000000000000000000000000000000000000000000000000000000000000000000000000000000000000000000001
444444444444444444444100000000000000000000000000000000000000000000000000000000000000000000000000000000000000000000000001
444444444444444444444100000000000000000000000000000000000000000000000000000000000000000000000000000000000000000000000001
444444444444444444444100000000000000000000000000000000000000000000000000000000000000000000000000000000000000000000000001
444444444444444444444100000000000000000000000000000000000000000000000000000000000000000000000000000000000000000000000001
444444444444444444444100000000000000000000000000000000000000000000000000000000000000000000000000000000000000000000000001
444444444444444444444100000000000000000022222222222222222222000000000000000000000000000000000000000000000000000000000001
444444444444444444444100000000000000000022222222222222222222000000000000000000000000000000000000000000000000000000000001
444444444444444444444100000000000000000000000000000000000000000000000000000000000000000000000000000000000000000000000001
444444444444444444444100000000000000000000000000000000000000000000000000000000000000000000000000000000000000000000000001
444444444444444444444100000000000000000000000000000000000000000000000000000000000000000000000000000000000000000000000001
444444444444444444444100000000000000000000000000000000000000000000000000000000000000000000000000000000000000000000000001
444444444444444444444100000000000000000000000000000000000000000000000000000000000000000000000000000000000000000000000001
444444444444444444444100000000000000000000000000000000000000000000000000000000000000000000000000000000000000000000000001
444444444444444444444100000000000000000000000000000000000000000000000000000000000000000000000000000000000000000000000001
444444444444444444444100000000000000000000000000000000000000000000000000000000000000000000000000000000000000000000000001
444444444444444444444100000000000000000022222222222222222222000000000000000000000000000000000000000000000000000000000001
444444444444444444444100000000000000000022222222222222222222000000000000000000000000000000000000000000000000000000000001
444444444444444444444100000000000000000000000000000000000000000000000000000000000000000000000000000000000000000000000001
444444444444444444444100000000000000000000000000000000000000000000000000000000000000000000000000000000000000000000000001
444444444444444444444100000000000000000000000000000000000000000000000000000000000000000000000000000000000000000000000001
444444444444444444444100000000000000000000000000000000000000000000000000000000000000000000000000000000000000000000000001
444444444444444444444100000000000000000000000000000000000000000000000000000000000000000000000000000000000000000000000001
444444444444444444444100000000000000000000000000000000000000000000000000000000000000000000000000000000000000000000000001
444444444444444444444100000000000000000000000000000000000000000000000000000000000000000000000000000000000000000000000001
444444444444444444444100000000000000000000000000000000000000000000000000000000000000000000000000000000000000000000000001
444444444444444444444111111111111111111111111111111111111111111111111111111111111111111111111111111111111111111111111111