11111111111111111111111111111111111111111111111111111111111111111111111111111111
10000000000000001000000000000000000000000000000000000000000000000000000000000001
10000000000000001000000000000000000000000000000000000000000000000000000000000001
10000000000000000000000000000000000000000000000000000000000000000000000000000001
10000000000000000000000000000000000000000000000000000000000000000000000000000001
10000000000000000000000000000000000000000000000000000000000000000000000000000001
10000000000000000000000000022222222224000000000000000000000000000000000000000001
10000000000000000000000000000000000000000000000000000000000000000000000000000001
10000000000000001000000000000000000000000000000000000000000000000000000000000001
10000000000000001000000000000000000000000000000000000000000000000000000000000000
10000000000000001000000000000000000000000000000000000000000000000000000000000000
11111111111111111000000000000000000000000000000000000000000000000000000000000000
                1000000000022222222225000000000000000000000000000000000000000000
                1000000000000000000000000000000000000000000000000000000000000000
                1000000000000000000000000000000000000000000000000000000000000000
                1000000000000000000000000000000000000000000000000000000000000000
                1000000000000000000000000000000000000000000000000000000000000001
                1000000000000000000000000000000000000000000000000000000000000001
                1000000000022222222226000000000000000000000000000000000000000001
                1000000000000000000000000000000000000000000000000000000000000001
                1000000000000000000000000000000000000000000000000000000000000001
                1000000000000000000000000000000000000000000000000000000000000001
                1000000000000000000000000000000000000000000000000000000000000001
                1000000000000000000000000000000000000000000000000000000000000001
                1111111111111111111111111111111111111111111111111111111111111111