1111111111111111111111111111111111111111111111111111111111111111111111111111111111111111111111111111111111111111111111111111111111111111111111111111111111111111
1000000000000000000001000000000000000000000000000000000000000000000000000000000000000000000000000000000000000000000000000000000000000000000000000000000000000001
1000000000000000000001000000000000000000000000000000000000000000000000000000000000000000000000000000000000000000000000000000000000000000000000000000000000000001
1000000000000000000000000000000000000000000000000000000000000000000000000000000000000000000000000000000000000000000000000000000000000000000000000000000000000001
1000000000000000000000000000000000000000000000000000000000000000000000000000000000000000000000000000000000000000000000000000000000000000000000000000000000000001
1000000000000000000000000000000000000000000000000000000000000000000000000000000000000000000000000000000000000000000000000000000000000000000000000000000000000001
1000000000000000000000000000000000000000000000000000000000000000000000000000000000000000000000000000000000000000000000000000000000000000000000000000000000000001
1000000000000000000000000000000000000000000000000000000000000000000000000000000000000000000000000000000000000000000000000000000000000000000000000000000000000001
1000000000000000000001000000000000000000222222222222222222222222222222222222222200000000000000000022222222222222222222222222222222222222220000000000000000000001
1000000000000000000001000000000000000000222222222222222222222222222222222222222200000000000000000022222222222222222222222222222222222222220000000000000000000001
1000000000000000000001000000000000000000222222222222222222222222222222222222222200000000000000000022222222222222222222222222222222222222220000000000000000000001
1111111111111111111111000000000000000000222222222222222222222222222222222222222200000000000000000022222222222222222222222222222222222222220000000000000000000001
4444444444444444444441000000000000000000000000000000000000000000000000000000000000000000000000000000000000000000000000000000000000000000000000000000000000000001
4444444444444444444441000000000000000000000000000000000000000000000000000000000000000000000000000000000000000000000000000000000000000000000000000000000000000001
4444444444444444444441000000000000000000000000000000000000000000000000000000000000000000000000000000000000000000000000000000000000000000000000000000000000000001
4444444444444444444441000000000000000000000000000000000000000000000000000000000000000000000000000000000000000000000000000000000000000000000000000000000000000001
4444444444444444444441000000000000000000000000000000000000000000000000000000000000000000000000000000000000000000000000000000000000000000000000000000000000000001
4444444444444444444441000000000000000000000000000000000000000000000000000000000000000000000000000000000000000000000000000000000000000000000000000000000000000001
4444444444444444444441000000000000000000000000000000000000000000000000000000000000000000000000000000000000000000000000000000000000000000000000000000000000000001
4444444444444444444441000000000000000000222222222222222222222222222222222222222200000000000000000000000000000000000000000000000000000000000000000000000000000001
4444444444444444444441000000000000000000222222222222222222222222222222222222222200000000000000000000000000000000000000000000000000000000000000000000000000000001
4444444444444444444441000000000000000000222222222222222222222222222222222222222200000000000000000000000000000000000000000000000000000000000000000000000000000001
4444444444444444444441000000000000000000222222222222222222222222222222222222222200000000000000000000000000000000000000000000000000000000000000000000000000000001
4444444444444444444441000000000000000000000000000000000000000000000000000000000000000000000000000000000000000000000000000000000000000000000000000000000000000001
4444444444444444444441000000000000000000000000000000000000000000000000000000000000000000000000000000000000000000000000000000000000000000000000000000000000000001
4444444444444444444441000000000000000000000000000000000000000000000000000000000000000000000000000000000000000000000000000000000000000000000000000000000000000001
4444444444444444444441000000000000000000000000000000000000000000000000000000000000000000000000000000000000000000000000000000000000000000000000000000000000000001
4444444444444444444441000000000000000000000000000000000000000000000000000000000000000000000000000000000000000000000000000000000000000000000000000000000000000001
4444444444444444444441000000000000000000000000000000000000000000000000000000000000000000000000000000000000000000000000000000000000000000000000000000000000000001
4444444444444444444441000000000000000000222222222222222222222222222222222222222200000000000000000000000000000000000000000000000000000000000000000000000000000001
4444444444444444444441000000000000000000222222222222222222222222222222222222222200000000000000000000000000000000000000000000000000000000000000000000000000000001
4444444444444444444441000000000000000000222222222222222222222222222222222222222200000000000000000000000000000000000000000000000000000000000000000000000000000001
4444444444444444444441000000000000000000222222222222222222222222222222222222222200000000000000000000000000000000000000000000000000000000000000000000000000000001
4444444444444444444441000000000000000000000000000000000000000000000000000000000000000000000000000000000000000000000000000000000000000000000000000000000000000001
4444444444444444444441000000000000000000000000000000000000000000000000000000000000000000000000000000000000000000000000000000000000000000000000000000000000000001
4444444444444444444441000000000000000000000000000000000000000000000000000000000000000000000000000000000000000000000000000000000000000000000000000000000000000001
4444444444444444444441000000000000000000000000000000000000000000000000000000000000000000000000000000000000000000000000000000000000000000000000000000000000000001
4444444444444444444441000000000000000000000000000000000000000000000000000000000000000000000000000000000000000000000000000000000000000000000000000000000000000001
4444444444444444444441000000000000000000000000000000000000000000000000000000000000000000000000000000000000000000000000000000000000000000000000000000000000000001
4444444444444444444441000000000000000000000000000000000000000000000000000000000000000000000000000000000000000000000000000000000000000000000000000000000000000001
4444444444444444444441000000000000000000000000000000000000000000000000000000000000000000000000000000000000000000000000000000000000000000000000000000000000000001
4444444444444444444441000000000000000000000000000000000000000000000000000000000000000000000000000000000000000000000000000000000000000000000000000000000000000001
4444444444444444444441000000000000000000000000000000000000000000000000000000000000000000000000000000000000000000000000000000000000000000000000000000000000000001
4444444444444444444441000000000000000000000000000000000000000000000000000000000000000000000000000000000000000000000000000000000000000000000000000000000000000001
4444444444444444444441000000000000000000000000000000000000000000000000000000000000000000000000000000000000000000000000000000000000000000000000000000000000000001
4444444444444444444441000000000000000000000000000000000000000000000000000000000000000000000000000000000000000000000000000000000000000000000000000000000000000001
4444444444444444444441000000000000000000000000000000000000000000000000000000000000000000000000000000000000000000000000000000000000000000000000000000000000000001
4444444444444444444441000000000000000000000000000000000000000000000000000000000000000000000000000000000000000000000000000000000000000000000000000000000000000001
4444444444444444444441000000000000000000000000000000000000000000000000000000000000000000000000000000000000000000000000000000000000000000000000000000000000000001
4444444444444444444441111111111111111111111111111111111111111111111111111111111111111111111111111111111111111111111111111111111111111111111111111111111111111111