11111111111111111111111111111111111111111111111111111111111111111111111111111111
10000000000000001000000000000000000000000000000000000000000000000000000000000001
10000000000000001000000000000000000000000000000000000000000000000000000000000001
10000000000000000000000000000000000000000000000000000000000000000000000000000001
10000000000000000000000000000000000000000000000000000000000000000000000000000001
10000000000000000000000000000000000000000000000000000000000000000000000000000001
10000000000000000000000000022222222222000000000022222222222000000000000000000001
10000000000000000000000000000000000000000000000000000000000000000000000000000001
10000000000000001000000000000000000000000000000000000000000000000000000000000001
10000000000000001000000000000000000000000000000000000000000000000000000000000003
10000000000000001000000000000000000000000000000000000000000000000000000000000003
11111111111111111000000000000000000000000000000000000000000000000000000000000003
44444444444444441000000000022222222222000000000022222222222000000000000000000003
44444444444444441000000000000000000000000000000000000000000000000000000000000003
44444444444444441000000000000000000000000000000000000000000000000000000000000003
44444444444444441000000000000000000000000000000000000000000000000000000000000003
44444444444444441000000000000000000000000000000000000000000000000000000000000001
44444444444444441000000000000000000000000000000000000000000000000000000000000001
44444444444444441000000000022222222222000000000022222222222000000000000000000001
44444444444444441000000000000000000000000000000000000000000000000000000000000001
44444444444444441000000000000000000000000000000000000000000000000000000000000001
44444444444444441000000000000000000000000000000000000000000000000000000000000001
44444444444444441000000000000000000000000000000000000000000000000000000000000001
44444444444444441000000000000000000000000000000000000000000000000000000000000001
44444444444444441111111111111111111111111111111111111111111111111111111111111111