#--------------------------------------------------------------------------------------------------#
|            #                                                                                     |
|    p       #                                                                                     |
|            #                                                                                     |
|            #                                                                                     |
|            =                                                                                     |
|#############                                                                                     |
|                                                                                                  |
|                                                                                                  |
|                                                                                                  |
|                                                                                                  |
|                                                                                                  |
|                                                                                                  |
|                                                                                                  |
|                                                                                                  |
|                                                                                                  |
|                                                                                                  |
|                                                                                                  |
|                                                                                                  |
#--------------------------------------------------------------------------------------------------#