11111111111111111111111111111111111111111111111111111111111111111111111111111111
10000000000100000000000000000000000000000000000000000000000000000000000000000001
10000000000000000000000000000000000000000000000000000000000000000000000000000001
10000000000000000000000000000000000000000000000000000000000000000000000000000001
10000000000100000000222222222220000000000000000000000000000000000000000000000001
10000000000100000000222222222220000000000000000000000000000000000000000000000001
10000000000100000000000000000000000000000000000000000000000000000000000000000001
10000000000100000000000000000000000000000000000000000000000000000000000000000001
10000000000100000000000000000000000000000000000000000000000000000000000000000001
11111111111100000000000000000000000000000000000000000000000000000000000000000001
44444444444100000000222222222220000000000000000000000000000000000000000000000001
44444444444100000000222222222220000000000000000000000000000000000000000000000001
44444444444100000000000000000000000000000000000000000000000000000000000000000001
44444444444100000000000000000000000000000000000000000000000000000000000000000001
44444444444100000000000000000000000000000000000000000000000000000000000000000001
44444444444100000000000000000000000000000000000000000000000000000000000000000001
44444444444100000000000000000000000000000000000000000000000000000000000000000001
44444444444100000000000000000000000000000000000000000000000000000000000000000001
44444444444100000000000000000000000000000000000000000000000000000000000000000001
44444444444111111111111111111111111111111111111111111111111111111111111111111111