#---------------------------------------*-LEVEL01-*-----------------------------------------------#
|      ]                             #                ]                            | | | | | | | | |
|      ]                             #                ]                            | | | | | | | | |
|      #                             #                #                           =================|
|      #                             #                #                           _________________|
|      #                             #                #                                            |
|#######                             #================#                                            |
|                                                                                                  |
|                                                                                                  |
|                                                                                                  |
|#####################################################################                             |
|                   ##                   ##                #         #                             |
|                   ##                   ##                #         #                             |
|                   ##                   ##                #         #                             |
|                   ##                   ##                #         #                             |
|###############====#################====##############====#         #                             |
|                                                                    #                             |
|                                                                    ]                             |
|                                                                    ]                             |
#--------------------------------------------------------------------------------------------------#