+----+----+----+----+----+----+----+----+----+----+----+----+----+----+----+----+----+----+----+----+
               |                        |              |                        |    |              |
+    +----+    +----+----+    +----+----+    +----+    +----+    +----+----+    +    +    +----+    +
|    |    |    |                             |    |    |                   |              |         |
+    +    +    +    +----+    +----+----+----+    +    +    +----+----+    +----+    +----+    +    +
|    |              |         |              |    |    |         |         |         |         |    |
+    +----+----+----+    +----+----+----+    +    +    +----+    +----+----+----+----+    +----+----+
|              |         |                   |              |              |              |         |
+----+----+    +    +----+    +    +----+----+----+    +    +----+    +    +    +----+----+    +    +
|         |    |    |    |    |                   |    |              |    |    |         |    |    |
+    +----+    +    +    +    +----+----+----+    +    +----+----+----+----+    +    +    +    +    +
|    |         |    |         |              |    |    |         |         |         |         |    |
+    +    +----+    +----+----+    +----+----+    +    +    +    +----+    +----+----+----+----+    +
|         |                   |    |         |         |    |         |         |              |    |
+----+----+    +----+----+    +    +    +    +    +----+    +----+    +----+    +    +----+----+    +
|              |              |         |         |         |    |              |                   |
+    +----+----+----+----+----+----+----+----+----+    +----+    +----+----+    +    +----+----+----+
|    |              |                   |    |         |                   |    |         |         |
+    +----+----+    +    +----+----+    +    +    +----+    +----+    +    +    +    +    +    +    +
|                   |              |                        |         |    |         |         |     
+----+----+----+----+----+----+----+----+----+----+----+----+----+----+----+----+----+----+----+----+
