+----+----+----+----+----+----+----+----+----+----+----+----+----+----+----+----+----+----+----+----+
     |              |              |         |                   |                                  |
+    +----+    +    +----+    +    +----+    +    +    +----+    +    +----+----+----+----+----+    +
|              |         |    |              |    |    |    |    |    |              |    |         |
+----+----+    +----+    +    +----+----+----+----+    +    +    +    +    +----+    +    +    +----+
|         |    |              |         |              |         |    |    |    |         |         |
+    +----+    +----+----+----+    +    +    +----+----+----+----+    +    +    +----+    +    +    +
|    |         |              |    |         |              |         |    |         |    |    |    |
+    +    +----+    +----+    +    +    +----+----+----+    +    +----+    +----+    +    +    +    +
|         |         |    |    |    |                        |         |         |    |         |    |
+    +----+    +----+    +    +    +----+----+----+----+----+----+    +----+    +    +----+----+    +
|              |    |         |    |         |         |              |    |         |              |
+    +----+----+    +    +----+    +    +    +----+    +    +----+----+    +----+----+    +----+----+
|    |              |              |    |         |                   |                   |         |
+    +    +----+    +----+    +----+    +----+    +    +----+    +----+----+    +----+----+----+    +
|    |         |    |    |              |         |         |    |         |         |              |
+    +----+    +    +    +----+----+----+    +    +----+    +    +    +    +----+    +    +----+----+
|    |         |         |              |    |         |    |         |    |    |    |              |
+    +    +----+----+----+    +    +    +----+----+    +    +----+----+    +    +    +    +----+    +
|         |                   |    |                        |              |              |          
+----+----+----+----+----+----+----+----+----+----+----+----+----+----+----+----+----+----+----+----+
