+----+----+----+----+----+----+----+----+----+----+----+----+----+----+----+----+----+----+----+----+
               |    |                             |              |                   |         |    |
+----+----+    +    +    +    +----+----+    +    +    +----+    +    +    +----+    +    +    +    +
|         |    |         |              |    |         |              |         |    |    |         |
+    +----+    +----+----+----+----+----+    +    +----+    +----+----+----+----+    +    +----+----+
|    |         |              |         |    |    |         |                        |              |
+    +    +----+----+----+    +    +    +    +----+    +----+----+----+----+----+----+----+    +    +
|    |              |              |    |         |    |         |                   |    |    |    |
+    +    +----+    +    +    +----+----+----+    +    +----+    +----+----+----+    +    +    +    +
|         |              |              |    |    |              |              |    |    |    |    |
+----+----+----+----+----+----+    +    +    +    +----+----+----+    +    +----+    +    +    +    +
|         |              |         |                             |    |                   |    |    |
+    +    +    +----+    +----+----+----+    +----+----+----+----+    +----+----+    +----+    +    +
|    |    |         |         |              |                   |         |         |    |    |    |
+    +    +----+    +----+    +    +----+----+    +----+----+    +----+    +----+----+    +    +    +
|    |              |    |    |              |         |    |    |    |              |         |    |
+    +----+    +----+    +    +    +----+----+----+    +    +    +    +----+    +    +----+    +----+
|         |    |    |    |    |              |         |         |    |         |                   |
+----+    +    +    +    +    +----+----+    +    +----+----+----+    +----+----+----+----+    +    +
|         |              |                                                                     |     
+----+----+----+----+----+----+----+----+----+----+----+----+----+----+----+----+----+----+----+----+