+----+----+----+----+----+----+----+----+----+----+----+----+----+----+----+----+----+----+----+----+
     |         |         |                   |         |              |              |    |         |
+    +    +    +    +    +    +----+    +    +    +    +    +----+    +----+----+    +    +    +    +
|    |    |         |         |         |    |    |         |    |              |         |    |    |
+    +    +----+    +----+----+    +----+    +    +----+----+    +----+----+    +----+    +    +    +
|    |         |              |         |    |                   |              |         |    |    |
+    +----+    +----+----+    +----+    +    +    +    +----+----+    +----+----+----+    +    +    +
|    |                   |    |         |    |    |    |         |         |              |    |    |
+    +----+    +----+----+    +    +----+    +----+    +    +----+----+    +    +----+----+    +----+
|         |    |              |    |    |    |         |    |              |    |                   |
+----+    +    +    +----+----+    +    +    +    +----+    +    +----+----+    +----+----+----+    +
|         |    |    |    |         |         |         |              |    |    |         |    |    |
+    +----+----+    +    +    +----+----+----+----+    +    +----+    +    +    +    +    +    +    +
|                   |    |                             |    |              |    |    |    |         |
+----+----+----+----+    +----+----+    +----+----+----+    +    +----+----+    +----+    +    +    +
|    |                        |         |    |         |    |         |         |         |    |    |
+    +    +----+----+    +----+    +----+    +    +    +    +----+    +    +----+    +----+    +    +
|    |         |    |    |              |         |    |    |         |                   |    |    |
+    +----+    +    +    +    +----+----+----+----+    +    +    +----+    +----+    +    +    +    +
|                   |         |                             |              |         |         |     
+----+----+----+----+----+----+----+----+----+----+----+----+----+----+----+----+----+----+----+----+
