 ______                  __  __            __    __                        ________  __ 
|      \                |  \|  \          |  \  |  \                      |        \|  \
 \$$$$$$ _______    ____| $$ \$$  ______  | $$\ | $$  ______               \$$$$$$$$ \$$
  | $$  |       \  /      $$|  \ |      \ | $$$\| $$ |      \                 /  $$ |  \
  | $$  | $$$$$$$\|  $$$$$$$| $$  \$$$$$$\| $$$$\ $$  \$$$$$$\               /  $$  | $$
  | $$  | $$  | $$| $$  | $$| $$ /      $$| $$\$$ $$ /      $$              /  $$   | $$
 _| $$_ | $$  | $$| $$__| $$| $$|  $$$$$$$| $$ \$$$$|  $$$$$$$             /  $$___ | $$
|   $$ \| $$  | $$ \$$    $$| $$ \$$    $$| $$  \$$$ \$$    $$            |  $$    \| $$
 \$$$$$$ \$$   \$$  \$$$$$$$ \$$  \$$$$$$$ \$$   \$$  \$$$$$$$             \$$$$$$$$ \$$