############################################################################################################################
##                      ##                                                     ##                                         ##
##    P                 ##                                                     ##                                         ##
##                      ##       #########################################     ##                                         ##
##                      ##       ##      ##                             ##     ##      ##############      ##########     ##
##                      ##       ##      ##                             ##     ##      ##                          ##     ##
##                               ##      ##                             ##     ##      ##                          ##     ##
##                               ##      #################      ##      ##     ##      ##      ##############      ##     ##
##                      ##       ##      ##             ##      ##      ##     ##      ##      ##          ##      ##     ##
##########################       ##      ##             ##      ##      ##     ##      ##      ##          ##      ##     ##
##                               ##      ##             ##      ##      ##     ##      ##      ##                  ##     ##
##                               ##      ##     ##      ##      ##      ##     ##      ##      ##                  ##     ##
##                               ##      ##     ##      ##      ##      ##     ##      ##      #############################
##      ###########################      ##     ##      ##      ##      ##     ##      ##                                 ##
##      ##                       ##      ##     ##      ##      ##      ##     ##      ##                                 ##
##      ##                       ##      ##     ##      ##      ##      ##     ##      ###############################    ##
##      ##                       ##      ##     ##      ##      ##      ##     ##                  ##               ##    ##
##      ##      ##########       ##      ##     ##      ##      ##      #########                  ##               ##    ##
##      ##      ##      ##       ##      ##     ##      ##      ##                         ##      ##       ##########    ##
##      ##      ##      ##       ##             ##              ##                         ##      ##       ##            ##
##      ##      ##      ##       ##             ##              ##                         ##      ##       ##            ##
##      ##      ##      ##       ##      ####################################################      ##       ##     #########
##      ##      ##      ##       ##                                                        ##      ##       ##     ##     ##
##              ##      ##       ##                                                        ##      ##       ##     ##     ##
##              ##      ##       ##                                                        ##      ##       ##            ##
##      ##      ##      ##       ###################################################       ##      ##       ##            ##
##      ##      ##                                    ##                                   ##      ##       ##     ##     ##
##      ##      ##                                    ##                                   ##      ##       ##     ##     ##
##      ##      ################################      ##                                   ##      ##       ##     ##     ##
##      ##                          ##        ##      ##     ################################      ##       ##     ##     ##
##      ##                          ##        ##      ##                                   ##      ##       ##     ##     ##
##      ##                          ##        ##      ##                                   ##      ##       ##     ##      E
##      ##############################        ##      ##                                   ##               ##     ##     ##
##                                            ##      ##############################       ##               ##     #########
##                                            ##                                           ##               ##            ##
##                                            ##                                           ##               ##            ##
############################################################################################################################