############################################################################################################################
##            ##     ##                   ##                                     ##                           ##          ##
##   E        ##                          ##   L                             E   ##   M                     ##        H   ##
##            ##     ##                   ##          #########  ########        ##          ##           ##              ##
##            ##            ##  ##  ##  ####          ##               ##        ##        ##           ##                ##
##            ##     ##     ##            ##          ##               ##        ##      ##           ##            ##    ##
##            ##            ##            ##############               ############    ##           ##            ##      ##
##            ##     ##     ##            ##          ##               ##        ##  ##           ##            ##        ##
##            ##            ##            ##          ##               ##        ####           ##            ##          ##
####  ##  ##  ##     ##     ##            ##          ########  #########        ##           ##            ##            ##
##                          ##        O   ##   K                             F   ##   N                   ##          G   ##
##                   ##     ##            ##                                     ##                     ##                ##
############################################################################################################################
##                                        ##                                     ##                                       ##
##  C        ##              ##       K   ##   N              ##             E   ##   M   #########################   B   ##
##             ##          ##             ##                  ##                 ##       ##                     ##       ##
##               ##      ##               ##                  ##                 ##       #########################       ##
##                 ##  ##                 ##                  ##                 ##                                       ##
##                   ##                   ##    #############################    ##                                       ##
##                 ##  ##                 ##                  ##                 ##                                       ##
##               ##      ##               ##                  ##                 ##       #########################       ##
##             ##          ##             ##                  ##                 ##       ##                     ##       ##
##  D        ##              ##       J   ##   O              ##             D   ##   L   #########################   G   ##
##                                        ##                                     ##                                       ##
############################################################################################################################
##                                        ##                           ##        ##                    ##                 ##
##  G       ##               ##       I   ##   A   ##                  ##    H   ##   A                ##                 ##
##          ##               ##           ##       ##                  ##        ##                    ##       ##        ##
##          ##     #####     ##           ##       #################   ##        ##                    ##       ##        ##
##############   ##     ##   ###############       ##                  ##        #################     ##       ##        ##
##               ##     ##                ##       ##                  ##        ##                    ##       ##        ##
##############     #####     ###############       ##                  ##        ##                    ##       ##        ##
##          ##               ##           ##       ##    ################        ##                    ##       ##        ##
##          ##               ##           ##       ##                  ##        ##       ###############       ##        ##
##  F       ##               ##       J   ##   I   ##                  ##    B   ##                             ##    P   ##
##                                        ##       ##                            ##                             ##        ##
############################################################################################################################