#########################################################################
##                      ##                                                                                       
##                      ##                                                                                              
##                      ##       ########################################                                        
##                      ##       ##      ##                                                                        
##                      ##       ##      ##                                                                                        
##                               ##      ##                                                                    
##                               ##      #################      ##                        
##                      ##       ##      ##             ##      ##                         
##########################       ##      ##             ##      ##                                                
##                               ##      ##             ##      ##                                                  
##                               ##      ##     ##      ##      ##                                           
##                               ##      ##     ##      ##      ##                          
##      ###########################      ##     ##      ##      ##                                                                                    
##      ##                       ##      ##     ##      ##      ##                                                      
##      ##                       ##      ##     ##      ##      ##                                              
##      ##                       ##      ##     ##      ##      ##                                        
##      ##      ##########       ##      ##     ##      ##      ##                                                  
##      ##      ##      ##       ##      ##     ##      ##      ##                                        
##      ##      ##      ##       ##             ##              ##                                                    
