#####################################
#    #####   ###       ###         ##
#  #######   #########      #####   
#  #######   #########   ############
#############   ########  ###########
#########      #########  ###########
#######   #### #####   ###### #######
###         ##  ####           ######
##########  ##   ### ################
#####################################